0000000000000000000000000000000000000000000000000000000000000000000000000000000
0000000000000000000000000000000000000000000000000000000000000000000000000000000
0000000000000000000000000000000000000000000000000000000000000000000000000000000
0000000000000000000000000000000000000000000000000000000000000000000000000000000
0000000000000000000000000000000000000000000000000000000000000000000000000000000
0000000000000000000000000000000000000000000000000000000000000000000000000000000
0000000000000000000000000000000000000000000000000000000000000000000000000000000
0000000000000000000000000000000000000000000000000000000000000000000000000000000
0000000000000000000000000000000000000000000000000000000000000000000000000000000
0000000000000000000000000000000000000000000000000000000000000000000000000000000
0000000000000000000000000000000000000000000000000001111111110000000000000000000
0000000000000000000000000000000000000000000000000001000000010000000000000000000
0000000000000000000000000000000000000000000000000001300000010000000000000000000
0000000000000000000000000000000000000000000000000001000030010000000000000000000
0000000000000000000000000000000000000000000000000001300000010000000000000000000
0000000000000000000000000000000000000000000000000001111001110000000000000000000
0000000000000000000000000000000000000000000000000000001001000000000000000000000
0000000000000000000000000000000000000000000000000000001001000000000000000000000
0000000000111111111100000111111111111111111111111111111001111111111111110000000
0000000000100000000100000100000000000000000000000000000000000000000000010000000
0000000000100300000100000100300000000000000000000330000003300000000000010000000
0000000000100000000111111100000000000000000300000000000000000000000330010000000
0000000000100000300000000000000000000000000300000003300003000000300000010000000
0000000000100000000000000000003000000300000300000003000000000000000000010000000
0000000000100000000111111100003000300030000000000300000000000003000030010000000
0000000000100030000100000100000003030000000300000000000030000000030030010000000
0000000000100000000100000100000003000000000300000000300030000000003000010000000
0000000000111111111100000111111111111111111111111111110000111111111111110000000
0000000000000000000000000000000000000000000000000000013000100000000000000000000
0000000000000000000000000000000000000000000000000000010000100000000000000000000
0000000000000000000000000000000111111111111111111111110030100000000000000000000
0000000000000000000000000000000122220000000000000000000000100000000000000000000
0000000000000000000000000000000122220000000000000300000300100000000000000000000
0000000000000000000000000000000122220000000000000030000000100000000000000000000
0000000000000000000000000000000111111111111111111111111111100000000000000000000
0000000000000000000000000000000000000000000000000000000000000000000000000000000
0000000000000000000000000000000000000000000000000000000000000000000000000000000
0000000000000000000000000000000000000000000000000000000000000000000000000000000
0000000000000000000000000000000000000000000000000000000000000000000000000000000
0000000000000000000000000000000000000000000000000000000000000000000000000000000
0000000000000000000000000000000000000000000000000000000000000000000000000000000
0000000000000000000000000000000000000000000000000000000000000000000000000000000
0000000000000000000000000000000000000000000000000000000000000000000000000000000
0000000000000000000000000000000000000000000000000000000000000000000000000000000
0000000000000000000000000000000000000000000000000000000000000000000000000000000